111111111111111
111111111111101
1000000000000P1
110000000000001
100000000000001
100000000000001
100000000000001
100000000000001
100000000000001
100000000000001
100000000000001
100000000000001
100000000000001
100000000000001
100000000000001
100000000000001
100000000000001
100000000000001
100000000000001
100000000000001
100000000000001
100000000011001
100000000EB1001
1000000000C0001
111111111111111
111111111111111
