111111111111111
111111111111101
100000000000001
11PE000000B0001
100000000000001
100000000000001
10C000000000001
100000000000001
100000000000001
100000000000001
100000000000001
100000000000001
100000000000001
100000000000001
100000000000001
100000000000001
100000000000001
100000000000001
1000000C0000001
100000000000001
100000000000001
100000000000001
100000000000001
100000000000001
111111111111111
111111111111111
