111111111111111
111111111111101
100000000000001
110000000000001
1P0000000000001
100000000000001
1EC000000000001
100000000000001
100000000000001
100000000000001
100000000000001
100000000000001
100000000000001
100000000000001
100000000000001
100000000000001
100000000000001
100000000000001
100000000000001
100000000000001
100000000000001
100000000000001
100000000000001
1000000000000B1
111111111111111
111111111111111
