111111111111111
111111111111101
100000000B00001
110000000000001
100000000000001
100000000000001
1EC000000000001
100000000000001
100000000000001
100000000000001
100000000000001
100000000000001
100000000000001
100000000000001
100000000000001
100000000000001
100000000000001
100000000000001
1000000C0000001
100000000000001
100000000000001
100000000000001
100000000000001
10000000P000001
111111111111111
111111111111111
