111111111111111
111111111111101
100000000E000P1
110000000000001
100000000000001
100000000000001
100000000000001
100000000000001
100000000000001
100000000000001
100000000000001
100000000000001
100000000000001
100000000000001
100000000000001
100000000000001
100000000000001
100000000000001
100000000000001
100000000000001
100000000000001
100000000011001
1000000000B1001
1000000000C0001
111111111111111
111111111111111
