111111111111111111111111111111111111111111111111111111111111
10C00000000C000000001000111111111111111111111111111011111101
100001111100011111000C00000000000000000000000000000011111101
100001000000010000000000000000000000000000000000000011111101
100001110000011100000100000000000000000000000000000011111101
100001000000010000000000000000000000000000000000000011111101
1000010000C00100000001001111111111111E1111111111111011111101
100001000000010000000100000000000000000000000000000011111101
10000000C000000001100100000000000000000000000000000011111101
100000000011000100000100000000000000000000000000000011111101
100001010110100001100000000000000000000000000000000011111101
10000000001010C001100100000000000000000000000000000011111101
10C00000000C000000001000000000000000000000000000000011111101
100001111100011111000C00000000000000000000000000000011111101
100011010000010000000000000000000000000000000000000011111101
100B11111000011101111111111000000000000C000P0000000011111101
100011111000011111111111111000000000000000000000000011111101
1000111110C0011111111111111000000000000000000000000011111101
100001000000010000000100000000000000000000000000000011111101
10000000C000000001100100000000000000000000000000000011111101
1000000000000000000000000000000000000000000000000000000000C1
100000000000000000000000000000000000000000000000000000000011
100000000000000000000000000000000000000000000000000000000011
100000000000000000000000000000000000000000000000000000000011
100000000000000000000000000000000000000000000000000000000011
100000000000000000000000000000000000000000000000000000000011
100000000000000000000000000000000000000000000000000000000011
100000000000000000000000000000000000000000000000000000000011
100000000000000000000000000000000000000000000000000000000011
100000000000000000000000000000000000000000000000000000000011
111111111111111111111111111111111111111111111111111111111111
