111111111111111111111111111111111111111111111111111111111111
100000000000000000001000111111111111111111111111111011111101
100001111100011111000000000000000000000000000000000011111101
100001000000010000000000000000000000000000000000000011111101
10000111000001110000010000000000000000000000000000C011111101
100001000000010000000000000000000000000000000000000011111101
100B010000000100000001001111111111111E1111111111111P11111101
100001000000010000000100000000000000000000000000000011111101
100000000000000001100100000000000000000000000000000011111101
100000000011000100000100000000000000000000000000000011111101
100001010110100001100000000000000000000000000000000011111101
100000000010100001100100000000000000000000000000000011111101
100000000000000000001000000000000000000000000000000011111101
100001111100011111000000000000000000000000000000000011111101
100011010000010000000000000000000000000000000000000011111101
100011111000011101111111111000000000000000000000000011111101
100011111000011111111111111000000000000000000000000011111101
100011111000011111111111111000000000000000000000000011111101
100001000000010000000100000000000000000000000000000011111101
100000000000000001100100000000000000000000000000000011111101
100000000000000000000000000000000000000000000000000000000001
100000000000000000000000000000000000000000000000000000000011
100000000000000000000000000000000000000000000000000000000011
100000000000000000000000000000000000000000000000000000000011
100000000000000000000000000000000000000000000000000000000011
100000000000000000000000000000000000000000000000000000000011
100000000000000000000000000000000000000000000000000000000011
100000000000000000000000000000000000000000000000000000000011
100000000000000000000000000000000000000000000000000000000011
100000000000000000000000000000000000000000000000000000000011
111111111111111111111111111111111111111111111111111111111111
