1111111111111
1000000000001
111000E000001
1C0000P000001
1111111111111
