1111111111111
100111CP00001
111000E000001
1B00000000001
1111111111111
