1111111111111
1000000000001
111000E000001
1CB000P000001
1111111111111
