1111111111111
1000000000001
111000E0000B1
1C0000P000001
1111111111111
