11111111111111111111111111
10000000000C00000000000001
100010000000011111100C0001
10001000000000000010000001
10001000000E00000C10000001
10BC1111100001111110000001
10000000100001000C00000001
10000000100001000000000001
10000000100001111110000001
10000000100001111110000001
10000000100001111110000001
10000000100001111110000001
10000000100001111110000001
10000000100001111110000001
10000000100001111110000001
10000000100001111110000001
10000000100001111110000001
10000000100001111110000001
10000000100001111110000001
10000000100001111110000001
10000000100001111110000001
10000000100001111110000001
10000000100001111110000001
10000000100001111110000001
10000000100001111110000001
10000000100001111110000001
10000000100001111110000001
10000000100001111110000001
10000000100001111110000001
10000000100001111110000001
10000000100001111110000001
10000000100001111110000001
10000000100001111110000001
10000000100001111110000001
10000000100001111110000P01
10000000000C00000000000001
11111111111111111111111111
