11111111111111111111111111111111111111111111111111111111
11111111111110111111111111111111110000000000000000000001
100000000E0000100000000000000000000000000000000000001001
11000000000000100000000000000000000000000000000000001001
10000000000000100000000000000000000000000000000000001001
10000000000000100000000000000000000000000000000000001001
10000000000000100000000000000000000000000000000000001001
10000000000000100000000000000000000000000000000000001001
10000000000000100000000000000000000000000000000000001001
10000000000000100000000000000000000000000000000000001001
10000000000000100000000000000000000000000000000000001001
10000000000000100000000000000000000000000000000000001001
1000000000000010000000000000000000000000C000000000001001
10000000000000100000000000000000000000000000000000001001
10000000000000100000000000000000000000000000000000001001
10000000000000100000000000000000000000000000000000001001
10000000001000000000000000000000000000000000000000001001
111B1111CCCCCCCCCCCCCCCCCCCCC000000000000000000000001P01
11111111111111111111111111111111111111111111111111111111
