111111111111111
111111111111101
100000000P00001
110000000E00001
100000000000001
100000000000001
100000000000001
100000000C00001
100000000000001
100000000000001
100000000000001
100000000000001
100000000000001
100000000000001
100000000000001
100000000000001
100000000000001
100000000000001
100000000000001
100000000000001
100000000000001
100000000000001
100000000000001
100000000B00001
111111111111111
111111111111111
